1111111111111111111111111111
1P0000000C00000000000C0000E1
1011110111110111110111110101
1000010000000100000100000101
1011010111100111100111100101
1C0010000X00000000000X0000C1
1111010111110111110111111101
1C00010000001000001000000001
1011101110110110110110111101
1000000000100000000100000001
1011110111100111100111101101
1X0000000C00000000000C0000X1
1011111111111111111111111101
1111111111111111111111111111